🌳🌳🌳🌳🌳🌳🌳🌳🌳🌳🌳🌳🌳🌳🌳🌳🌳🌳🌳🌳🌳🌳🌳🌳🌳🌳🌳🌳🌳🌳
🌳🌾🌾🌾🌾🌾🌾🌾🌾🌾🌾🌾🌾🌾🌾🌾🌾🌾🌾🌾🌾🌾🌾🌾🌾🌾🌾🌾🌾🌳
🌳🌾🌾🌾🌾🌾🌾🌾🌾🌾🌾🌾🌾🌾🌾🌾🌾🌾🌾🌾🌾🌾🌾🌾🌾🌾🌾🌾🌾🌳
🌳🌾🌾🌾🌾🌾🌾🌾🌾🌾🌾🌾🌾🌾🌾🌾🌾🌾🌾🌾🌾🌾🌾🌾🌾🌾🌾🌾🌾🌳
🌳🌾🌾🌾🌾🌾🌾🌾🌾🌾🪨🪨🪨🌾🌾🌾🌾🌾🌾🌾🌾🌾🌾🌾🌾🌾🌾🌾🌾🌳
🌳🌾🌾🌾🌾🌾🌾🌾🌾🌾🪨🪨🪨🌾🌾🌾🌾🌾🌾🌾🌾🌾🌾🌾🌾🌾🌾🌾🌾🌳
🌳🌾🌾🌾🌾🌾🌾🌾🌾🌾🪨🪨🪨🌾🌾🌾🌾🌾🌾🌾🌾🌾🌾🌾🌾🌾🌾🌾🌾🌳
🌳🌾🌾🌾🌾🌾🌾🌾🌾🌾🌾🌾🌾🌾🌾🌾🌾🌾🌾🌾🌾🌾🌾🌾🌾🌾🌾🌾🌾🌳
🌳🌾🌾🌾🌾🌾🌾🌾🌾🌾🌾🌾🌾🌾🌾🌾🌾🌾🌾🌾🌾🌾🌾🌾🌾🌾🌾🌾🌾🌳
🌳🌾🌾🌾🌾🌾🌾🌾🌾🌾🌾🌾🌾🌾🌾🌾🌾🌾🌾🌾🌾🌾🌾🌾🌾🌾🌾🌾🌾🌳
🌳🌾🌾🌾🌾🌾🌾🌾🌾🌾🌾🌾🌾🌾🌾🌾🌾🌾🌾🌾🌾🌾🌾🌾🌾🌾🌾🌾🌾🌳
🌳🌾🌾🌾🌾🌾🌾🌾🌾🌾🌾🌾🌾🌾🌾🌾🌾🌾🌾🌾🌾🌾🌾🌾🌾🌾🌾🌾🌾🌳
🌳🌾🌾🌾🌾🌾🌾🌾🌾🌾🌾🌾🌾🏠🏠🏠🌾🌾🌾🌾🌾🌾🌾🌾🌾🌾🌾🌾🌾🌳
🌳🌾🌾🌾🌾🌾🌾🌾🌾🌾🌾🌾🌾🏠🚪🏠🌾🌾🌾🌾🌾🌾🌾🌾🌾🌾🌾🌾🌾🌳
🌳🌾🌾🌾🌾🌾🌾🌾🌾🌾🌾🌾🌾🏠🏠🏠🌾🌾🌾🌾🌾🌾🌾🌾🌾🌾🌾🌾🌾🌳
🌳🌾🌾🌾🌾🌾🌾🌾🌾🌾🌾🌾🌾🌾🌾🌾🌾🌾🌾🌾🌾🌾🌾🌾🌾🌾🌾🌾🌾🌳
🌳🌾🌾🌾🌾🌾🌾🌾🌾🌾🌾🌾🌾🌾🌾🌾🌾🌾🌾🌾🌾🌾🌾🌾🌾🌾🌾🌾🌾🌳
🌳🌾🌾🌾🌾🌾🌾🌾🌾🌾🌾🌾🌾🌾🌾🌾🌾🌾🌾🌾🌾🌾🌾🌾🌾🌾🌾🌾🌾🌳
🌳🌾🌾🌾🌾🌾🌾🌾🌾🌾🌾🌾🌾🌾🌾🌾🌾🌾🌾🌾🌾🌾🌾🌾🌾🌾🌾🌾🌾🌳
🌳🌾🌾🌾🌾🌾🌾🌾🌾🌾🌾🌾🌾🌾🌾🌾🌾🌾🌾🌾🌾🌾🌾🌾🌾🌾🌾🌾🌾🌳
🌳🌾🌾🌾🌾🌾🌾🌾🌾🌾🌾🌾🌾🌾🌾🌾🌾🌾🌾🌾🌾🌾🌾🌾🌾🌾🌾🌾🌾🌳
🌳🌾🌾🌾🌾🌾🌾🌾🌾🌾🌾🌾🌾🌾🌾🌾🌾🌾🌾🌾🌾🌾🌾🌾🌾🌾🌾🌾🌾🌳
🌳🌾🌾🌾🌾🌾🌾🌾🌾🌾🌾🌾🌾🌾🌾🌾🌾🌾🌾🌾🌾🌾🌾🌾🌾🌾🌾🌾🌾🌳
🌳🌾🌾🌾🌾🌾🌾🌾🌾🌾🌾🌾🌾🌾🌾🌾🌾🌾🌾🌾🌾🌾🌾🌾🌾🌾🌾🌾🌾🌳
🌳🌾🌾🌾🌾🌾🌾🌾🌾🌾🌾🌾🌾🌾🌾🌾🌾🌾🌾🌾🌾🌾🌾🌾🌾🌾🌾🌾🌾🌳
🌳🌾🌾🌾🌾🌾🌾🌾🌾🌾🌾🌾🌾🌾🌾🌾🌾🌾🌾🌾🌾🌾🌾🌾🌾🌾🌾🌾🌾🌳
🌳🌾🌾🌾🌾🌾🌾🌾🌾🌾🌾🌾🌾🌾🌾🌾🌾🌾🌾🌾🌾🌾🌾🌾🌾🌾🌾🌾🌾🌳
🌳🌾🌾🌾🌾🌾🌾🌾🌾🌾🌾🌾🌾🌾🌾🌾🌾🌾🌾🌾🌾🌾🌾🌾🌾🌾🌾🌾🌾🌳
🌳🌾🌾🌾🌾🌾🌾🌾🌾🌾🌾🌾🌾🌾🌾🌾🌾🌾🌾🌾🌾🌾🌾🌾🌾🌾🌾🌾🌾🌳
🌳🌳🌳🌳🌳🌳🌳🌳🌳🌳🌳🌳🌳🌳🌳🌳🌳🌳🌳🌳🌳🌳🌳🌳🌳🌳🌳🌳🌳🌳
