##############################
#............................#
#............................#
#.............N..............#
#............................#
#............................#
#............................#
#............................#
#............................#
#............................#
#.............P..............#
#............................#
#............................#
#............................#
#............................#
#............................#
#............................#
#............................#
#............................#
#............................#
#............................#
#............................#
#............................#
#............................#
#............................#
#............................#
#............................#
#............................#
#............................#
##############################
